1111111111111111111111111111111111
1CCCCCCCCCCCCCCCCCCCCCCCCCCCCC1111
1CC1C11111CCCCCCCCCCCCCCCCCCCC1111
1CC1C11111CCCCCCCCCCCCCCCCCCCC1111
1CC1C11111CCCCCCCCCCCCCCCCCCCC1111
1CC1C11111CCCCCCCCCCCCCCCCCCCC1111
1CC1C11111CCCCCCCCCCCCCCCCCCCC1111
1CC1C11111CCCCCCCCCCCCCCCCCCCC1111
1CC1C11111CCCCCCCCCCCCCCCCCCCC1111
1CC1C11111CCCCCCCCCCCCCCCCCCCC1111
1CC1C11111CCCCCCCCCCCCCCCCCCCC1111
1CC1C11111CCCCCCCCCCCCCCCCCCCC1111
1CC1C11111CCCCCCCCCCCCCCCCCCCC1111
1CC1C11111CCCCCCCCCCCCCCCCCCCC1111
1CC1CCCCCCCCCCCCCCCCCCCCCCCCPC1111
1CC1CCCCCCCCCCCCCCCCCCCCCCCCEC1111
1CCC11111C11CCCCCCCCCCCCCCCCCCCCC1
1111111111111111111111111111111111
