111111111111
1000C0010001
111101010111
100001010001
111011111101
10C000010101
111111010101
1C0000010001
110010010001
10101E000101
1C10100100P1
111111111111