1111111111111111111111111111
10E00000000PC000000000000001
1111111111111111111111111111