1111111111
1000000001
1000100C01
1P00000E01
1111111111
