111111111111
1000C0010001
111101010111
100001010001
111011111101
10C000010101
111111010101
1C000001P101
101010010001
101010000101
1E1010010101
111111111111
